              1111111111222222222233
    01234567890123456789012345678901
00  SSSSSS.SSSSSSSSSSSSSSSSSS.SSSSSS
01  SSSSSS.SSSSSSSSSSSSSSSSSS.SSSSSS
02  SSSSSS.SSSSSSSSSSSSSSSSSS.SSSSSS
03  ...SSSSSS.SSS......SSS.SSSSSS...
04  SSSSSSSSS.SSSSSSSSSSSS.SSSSSSSSS
05  SSSSSSSSS.SSSSSSSSSSSS.SSSSSSSSS
06  SSS..........SSSSSS..........SSS
07  SSS..SSS..SSSSSSSSSSSS..SSS..SSS
08  SSS..SSSUUSSSSSSSSSSSSUUSSS..SSS
09  SSS..SSSUUSSSSSSSSSSSSUUSSS..SSS
10  SSSSSS.SSSSSSSSSSSSSSSSSS.SSSSSS
11  SSSSSS.SSSSSSSSSSSSSSSSSS.SSSSSS
12  SSSSSS.SSSSSSSSSSSSSSSSSS.SSSSSS
13  SSSSSSSSSSSSSSS..SSSSSSSSSSSSSSS
14  SSSSSSSSSSSSSSS..SSSSSSSSSSSSSSS
15  SSSSSSSSSSSSSSS..SSSSSSSSSSSSSSS
16  SSSSSSSSSSSSSSS..SSSSSSSSSSSSSSS
17  SSSSSSSSSSSSSSS..SSSSSSSSSSSSSSS
18  SSSSSSSSSSSSSSS..SSSSSSSSSSSSSSS
19  SSSSSS.SSSSSSSSSSSSSSSSSS.SSSSSS
20  SSSSSS.SSSSSSSSSSSSSSSSSS.SSSSSS
21  SSSSSS.SSSSSSSSSSSSSSSSSS.SSSSSS
22  SSS..SSSUUSSSSSSSSSSSSUUSSS..SSS
23  SSS..SSSUUSSSSSSSSSSSSUUSSS..SSS
24  SSS..SSS..SSSSSSSSSSSS..SSS..SSS
25  SSS..........SSSSSS..........SSS
26  SSSSSSSSS.SSSSSSSSSSSS.SSSSSSSSS
27  SSSSSSSSS.SSSSSSSSSSSS.SSSSSSSSS
28  ...SSSSSS.SSS......SSS.SSSSSS...
29  SSSSSS.SSSSSSSSSSSSSSSSSS.SSSSSS
30  SSSSSS.SSSSSSSSSSSSSSSSSS.SSSSSS
31  SSSSSS.SSSSSSSSSSSSSSSSSS.SSSSSS
Legend: S=solar panel, s=small pole, m=medium pole, B=big pole, U=substation, .=empty
