              1111111111222222222233
    01234567890123456789012345678901
00  ................................
01  .SSSSSSSSSSSSSSSSSSSSSSSSSSSSSS.
02  .SSSSSSSSSSSSSSSSSSSSSSSSSSSSSS.
03  .SSSSSSSSSSSSSSSSSSSSSSSSSSSSSS.
04  .SSSUU.SSSSSSSSSSSS.UUSSSSSSSSS.
05  .SSSUU.SSSSSSSSSSSS.UUSSSSSSSSS.
06  .SSS...SSSSSSSSSSSS...SSSSSSSSS.
07  .SSSSSSSSSSSSSSSSSSSSSSSSSSSSSS.
08  .SSSSSSSSSSSSSSSSSSSSSSSSSSSSSS.
09  .SSSSSSSSSSSSSSSSSSSSSSSSSSSSSS.
10  .SSSSSSSSSSSSSSSSSSSSSSSSSSSSSS.
11  .SSSSSSSSSSSSSSSSSSSSSSSSSSSSSS.
12  .SSSSSSSSSSSSSSSSSSSSSSSSSSSSSS.
13  .SSSSSSSSSSSSSSSSSSSSSSSSSSSSSS.
14  .SSSSSSSSSSSSSSSSSSSSSSSSSSSSSS.
15  .SSSSSSSSSSSSSSSSSSSSSSSSSSSSSS.
16  .SSSSSSSSSSSSSSSSSSSSSSSSSSSSSS.
17  .SSSSSSSSSSSSSSSSSSSSSSSSSSSSSS.
18  .SSSSSSSSSSSSSSSSSSSSSSSSSSSSSS.
19  .SSS...SSSSSSSSSSSS...SSSSSSSSS.
20  .SSSUU.SSSSSSSSSSSS.UUSSSSSSSSS.
21  .SSSUU.SSSSSSSSSSSS.UUSSSSSSSSS.
22  .SSSSSSSSSSSSSSSSSSSSSSSSSSSSSS.
23  .SSSSSSSSSSSSSSSSSSSSSSSSSSSSSS.
24  .SSSSSSSSSSSSSSSSSSSSSSSSSSSSSS.
25  .SSSSSSSSSSSSSSSSSSSSSSSSSSSSSS.
26  .SSSSSSSSSSSSSSSSSSSSSSSSSSSSSS.
27  .SSSSSSSSSSSSSSSSSSSSSSSSSSSSSS.
28  .SSSSSSSSSSSSSSSSSSSSSSSSSSSSSS.
29  .SSSSSSSSSSSSSSSSSSSSSSSSSSSSSS.
30  .SSSSSSSSSSSSSSSSSSSSSSSSSSSSSS.
31  ................................
Legend: S=solar panel, s=small pole, m=medium pole, B=big pole, U=substation, .=empty
